26
17
20 21 22 23 24 23 21 T T 24 22 21 22 23 24 22 21 22 23 24 22 24 22 24 22 25
26 0 2 2 1 1 1 2 2 1 1 1 2 2 1 1 1 2 2 2 2 1 1 2 3  27
38 4 5 6 5 5 5 6 6 5 5 5 6 6 5 5 5 6 6 6 6 5 6 6 7 39
26 4 5 5 6 6 5 5 5 6 6 6 5 5 6 6 5 5 6 5 6 6 6 6 7 25
38 4 6 6 6 5 6 5 6 6 5 5 6 6 6 5 6 6 5 6 5 6 6 6 7 39
L 4 5 6 5 5 5 6 6 5 5 6 5 6 5 5 5 6 6 6 6 5 6 6 7 R
L 4 5 5 6 6 5 6 5 6 6 6 5 5 6 6 5 5 6 5 6 6 6 6 7 R
26 4 6 6 6 5 6 5 6 6 5 5 6 6 6 5 6 6 6 6 5 6 6 6 7 25
26 4 6 6 6 5 6 5 6 6 5 5 6 6 6 5 6 6 6 6 5 6 6 6 7 25
26 4 6 6 6 5 6 5 6 6 5 5 6 6 6 5 6 6 6 6 5 6 6 6 7 25
26 4 6 6 6 5 6 5 6 6 5 5 6 6 6 5 6 6 6 6 5 6 6 6 7 25
26 4 5 5 6 6 5 5 5 6 6 6 5 5 6 6 5 5 6 6 6 6 6 6 7 25
38 4 6 6 6 5 6 5 6 6 5 5 6 6 6 5 6 6 5 6 6 6 6 6 7 39
26 4 5 6 5 5 5 6 6 5 5 5 6 6 5 5 5 6 6 5 6 6 6 6 7 25
38 4 5 5 6 6 5 5 5 6 6 6 5 5 6 6 5 5 6 6 6 6 6 6 7 39
26 8 10 10 10 9 10 9 10 10 9 9 10 9 10 10 10 10 9 10 11 10 11 10 11 25
28 30 29 30 29 30 29 B B 30 29 30 29 30 29 30 29 30 29 30 29 30 29 30 29 33