1 2 2 2 2 2 2 2 1 1 1 1 1 1 1 1 1 1 1 1 1 1 1 1 1 1 1 1 1 1 1 1 1 1 1 1 1 1 1 1 1 1 1 1 1 1 1 1 1 1 1
1 1 1 1 1 1 1 1 1 1 1 1 1 1 1 1 1 1 1 1 1 1 1 1 1 1 1 1 1 1 1 1 1 1 1 1 1 1 1 1 1 1 1 1 1 1 1 1 1 1 1
1 2 3 4 5 6 7 8 9 10 10 1 1 1 1 1 1 1 1 1 1 1 1 1 1 1 1 1 1 1 1 1 1 1 1 1 1 1 1 1 1 1 1 1 1 1 1 1 1 1 1 1
1 1 1 1 1 1 1 1 1 1 1 1 1 1 1 1 1 1 1 1 1 1 1 1 1 1 1 1 1 1 1 1 1 1 1 1 1 1 1 1 1 1 1 1 1 1 1 1 1 1 1
1 1 1 1 1 1 1 1 1 1 1 1 1 1 1 1 1 1 1 1 1 1 1 1 1 1 1 1 1 1 1 1 1 1 1 1 1 1 1 1 1 1 1 1 1 1 1 1 1 1 1
1 1 1 1 1 1 1 1 1 1 1 1 1 1 1 1 1 1 1 1 1 1 1 1 1 1 1 1 1 1 1 1 1 1 1 1 1 1 1 1 1 1 1 1 1 1 1 1 1 1 1
1 1 1 1 1 1 1 1 1 1 1 1 1 1 1 1 1 1 1 1 1 1 1 1 1 1 1 1 1 1 1 1 1 1 1 1 1 1 1 1 1 1 1 1 1 1 1 1 1 1 1
1 1 1 1 1 1 1 1 1 1 1 1 1 1 1 1 1 1 1 1 1 1 1 1 1 1 1 1 1 1 1 1 1 1 1 1 1 1 1 1 1 1 1 1 1 1 1 1 1 1 1
1 1 1 1 1 1 1 1 1 1 1 1 1 1 1 1 1 1 1 1 1 1 1 1 1 1 1 1 1 1 1 1 1 1 1 1 1 1 1 1 1 1 1 1 1 1 1 1 1 1 1
1 1 1 1 1 1 1 1 1 1 1 1 1 1 1 1 1 1 1 1 1 1 1 1 1 1 1 1 1 1 1 1 1 1 1 1 1 1 1 1 1 1 1 1 1 1 1 1 1 1 1



30
17
0 1 2 3 1 2 3 1 2 3 1 2 3 1 2 3 1 2 3 1 1 2 3 1 2 3 1 2 3 1 2 3 1 2 3 1 2 3 1 5 6
0 6 7 6 8 6 9 6 16 18 17 6 6 6 6 16 6 6 6 19 6 6 9 6 6 7 6 6 8 6 6 8 7 6 7 6 8 6 6 5
0 6 6 6 7 6 6 7 6 6 8 6 6 17 6 6 6 17 6 6 6 7 6 8 18 9 6 16 18 17 6 6 9 6 6 16 6 6 7 5
0 6 7 6 8 6 9 6 16 18 17 6 6 6 6 16 6 6 6 19 6 6 9 6 6 7 6 6 8 6 6 8 7 6 7 6 8 6 6 5
0 6 6 6 7 6 6 7 6 6 8 6 6 17 6 6 6 17 6 6 6 7 6 8 18 9 6 16 18 17 6 6 9 6 6 16 6 6 7 5
0 6 7 6 8 6 9 6 16 18 17 6 6 6 6 16 6 6 6 19 6 6 9 6 6 7 6 6 8 6 6 8 7 6 7 6 8 6 6 5
0 6 6 6 7 6 6 7 6 6 8 6 6 17 6 6 6 17 6 6 6 7 6 8 18 9 6 16 18 17 6 6 9 6 6 16 6 6 7 5
0 6 7 6 8 6 9 6 16 18 17 6 6 6 6 16 6 6 6 19 6 6 9 6 6 7 6 6 8 6 6 8 7 6 7 6 8 6 6 5
0 6 6 6 7 6 6 7 6 6 8 6 6 17 6 6 6 17 6 6 6 7 6 8 18 9 6 16 18 17 6 6 9 6 6 16 6 6 7 5
0 6 7 6 8 6 9 6 16 18 17 6 6 6 6 16 6 6 6 19 6 6 9 6 6 7 6 6 8 6 6 8 7 6 7 6 8 6 6 5
0 6 6 6 7 6 6 7 6 6 8 6 6 17 6 6 6 17 6 6 6 7 6 8 18 9 6 16 18 17 6 6 9 6 6 16 6 6 7 5
0 6 7 6 8 6 9 6 16 18 17 6 6 6 6 16 6 6 6 19 6 6 9 6 6 7 6 6 8 6 6 8 7 6 7 6 8 6 6 5
0 6 6 6 7 6 6 7 6 6 8 6 6 17 6 6 6 17 6 6 6 7 6 8 18 9 6 16 18 17 6 6 9 6 6 16 6 6 7 5
0 6 7 6 8 6 9 6 16 18 17 6 6 6 6 16 6 6 6 19 6 6 9 6 6 7 6 6 8 6 6 8 7 6 7 6 8 6 6 5
0 6 6 6 7 6 6 7 6 6 8 6 6 17 6 6 6 17 6 6 6 7 6 8 18 9 6 16 18 17 6 6 9 6 6 16 6 6 7 5
0 6 7 6 8 6 9 6 16 18 17 6 6 6 6 16 6 6 6 19 6 6 9 6 6 7 6 6 8 6 6 8 7 6 7 6 8 6 6 5
0 6 6 6 7 6 6 7 6 6 8 6 6 17 6 6 6 17 6 6 6 7 6 8 18 9 6 16 18 17 6 6 9 6 6 16 6 6 7 5