23
20
20 21 22 23 24 23 21 6 6 24 22 21 22 23 24 22 21 22 23 24 22 22 25
26 0 2 2 1 1 1 2 2 1 1 1 2 2 1 1 1 2 2 1 3 3 27
38 4 5 6 5 5 5 6 6 5 5 5 6 6 5 5 5 6 6 5 7 7 39
26 4 5 5 6 6 5 5 5 6 6 6 5 5 6 6 5 5 6 6 7 7 25
38 4 6 6 6 5 6 5 6 6 5 5 6 6 6 5 6 6 5 6 7 7 39
6 4 5 6 5 5 5 6 6 5 5 5 6 6 5 5 5 6 6 5 7 7 6
6 4 5 5 6 6 5 6 5 6 6 6 5 5 6 6 5 5 6 6 7 7 6
26 4 6 6 6 5 6 5 6 6 5 5 6 6 6 5 6 6 5 6 7 7 25
26 4 5 5 6 6 5 5 5 6 6 6 5 5 6 6 5 5 6 6 7 7 25
38 4 6 6 6 5 6 5 6 6 5 5 6 6 6 5 6 6 5 6 7 7 39
38 4 6 6 6 5 6 5 6 6 5 5 6 6 6 5 6 6 5 6 7 7 39
38 4 6 6 6 5 6 5 6 6 5 5 6 6 6 5 6 6 5 6 7 7 39
38 4 6 6 6 5 6 5 6 6 5 5 6 6 6 5 6 6 5 6 7 7 39
38 4 6 6 6 5 6 5 6 6 5 5 6 6 6 5 6 6 5 6 7 7 39
38 4 6 6 6 5 6 5 6 6 5 5 6 6 6 5 6 6 5 6 7 7 39
38 4 6 6 6 5 6 5 6 6 5 5 6 6 6 5 6 6 5 6 7 7 39
26 4 5 6 5 5 5 6 6 5 5 5 6 6 5 5 5 6 6 5 7 7 25
38 4 5 5 6 6 5 5 5 6 6 6 5 5 6 6 5 5 6 6 7 7 39
26 8 10 10 10 9 10 9 10 10 9 9 10 9 10 10 10 10 9 10 11 11 25
28 30 29 30 29 30 29 6 6 30 29 30 29 30 29 30 29 30 29 30 29 29 33